22 21
#####################
#$********#*********#
#*###*###*#*###D###*#
#*###*###*#*###*###*#
#******************$#
#*##*#%#######*#*##*#
#****#****#****#****#
####*####*#*####*####
   #*#****$****#*#   
####*#*###*###*#*####
***D***#&& &&#***%***
####*#*#######*#*####
   #*#*********#*#   
####*#*#######$#*####
#*********#*********#
#*##*####*#*####*##*#
#**#******D******#**#
##*#*#*#######*#*#*##
#****#****#****#****#
#*#######*#*#######%#
#$********a*********#
#####################